Iono	KEYWORD1
IonoUDP	KEYWORD1
IonoWeb	KEYWORD1
WebServer	KEYWORD1
IonoEQ	KEYWORD1
read	KEYWORD2
write	KEYWORD2
flip	KEYWORD2
subscribeDigital	KEYWORD2
subscribeAnalog	KEYWORD2
process	KEYWORD2
begin	KEYWORD2
processRequest	KEYWORD2
subscribe	KEYWORD2
attachShutoffISR	KEYWORD2
detachShutoffISR	KEYWORD2
attachProcessingISR	KEYWORD2
detachProcessingISR	KEYWORD2
readD7S	KEYWORD2
writeD7S	KEYWORD2
adjust	KEYWORD2
readState	KEYWORD2
readAxisState	KEYWORD2
readEvent	KEYWORD2
readMode	KEYWORD2
writeMode	KEYWORD2
readCtrl	KEYWORD2
writeCtrl	KEYWORD2
readClearCommand	KEYWORD2
writeClearCommand	KEYWORD2
readCurrentSI	KEYWORD2
readCurrentPGA	KEYWORD2
readLatestOffsetX	KEYWORD2
readLatestOffsetY	KEYWORD2
readLatestOffsetZ	KEYWORD2
readLatestTemp	KEYWORD2
readLatestSI	KEYWORD2
readLatestPGA	KEYWORD2
readRankedOffsetX	KEYWORD2
readRankedOffsetY	KEYWORD2
readRankedOffsetZ	KEYWORD2
readRankedTemp	KEYWORD2
readRankedSI	KEYWORD2
readRankedPGA	KEYWORD2
